0RR00000000RR022220000000RR0
0RR00000000RR000000000000RR0
0000222222222000000022200000
0000220000000000000022200000
0000220000000000222222200000
0022000000000000002222200000
0022000000000000000022200000
0000000000000000000022200000
0000000000000000000022222000
0000000000000000000000222000
0000000000000000000000000000
0000000000000000000000000000
1100111110000000000111110011
2200111110000000000111110022
0000000000011001100000000000
0000000000011111100000000000
0011000110011111100110011000
0011000110011001100110011000
0011000110011001100110011000
0011000110011001100110011000
0011000110000000000110011000
0011000110000000000110011000
0000000000001111000000000000
0000000000001551000000000000
2222000000001551000000000000