0RR0000000000010000000000RR0
0RR0000000000000000000000RR0
0001100110011001100110011000
0011100110011001100110011100
0011100110011001100110011100
0011100110011221100110011100
0011100110011221100110011100
0011100110011001100110011100
0011100110000000000110011100
0011100110000000000110011100
0000000000011001100000000000
0000000000011001100000000000
1100111110000000000111110011
2200111110000000000111110022
0000000000011001100000000000
0000000000011111100000000000
0011000110011111100110011000
0011000110011001100110011000
0011000110011001100110011000
0011000110011001100110011000
0011000110000000000110011000
0011000110000000000110011000
0000000000001111000000000000
0000000000001551000000000000
0000000000001551000000000000